
 _     _____ _     _____ _       ____    _    ____   _____       _    ____       _    ____    ____    ____ 
/ \   /  __// \ |\/  __// \     /  _ \  / \  /_   \  \__  \  /\ / |  / ___\   __/ \  / _  \  / ___\  /__  \
| |   |  \  | | //|  \  | |     | / \|  | |   /   /    /  |  \_\| |  |    \  /__  |  \/ | |  \ \ //  |\/  |
| |_/\|  /_ | \// |  /_ | |_/\  | \_/|  | |  /   /_   _\  |     | |  \___ |  |\/  |     | |  / /_\\  \__  |
\____/\____\\__/  \____\\____/  \____/  \_/  \____/  /____/     \_|  \____/  \____/     \_/  \____/     \_/
                                                                                                           
